##############################
#  s #                    #  #
#    #                    #  #
#    #  ################  #  #
#    #  #                 #  #
#    #  #############     #  #
#    #  #     e     #     #  #
#    #  #   #########     #  #
#    #  #                 #  #
#    #  ###################  #
#                            #
##############################