####################
#                  #
#   #####       e  #
#      ## ####### ##
# # ##   # #       #
###  ##########    #
#s                 #
####################