####################
#  s #          #e #
##   #    #     #  #
#  ###  ######  #  #
###  ## #       #  #
#  ###  #  ######  #
#      ##          #
####################