####################
#  s            #e #
##   #          #  #
#   ##  ######     #
#    #  #       #  #
#    #  #  ######  #
#       #          #
####################