####################
#  s #          #e #
##   #          #  #
#   ##  ######  #  #
#    #  #       #  #
#    #  #  ######  #
#       #          #
####################